1 templates
F0
WWWWWWWWWWWWWWWW
WHHHHHH..HHHHHHW
WH............HW
WH.HHHHHHHH.H.HW
W......S....H..W
W..H...........W
WH.H.HHHHHHHH.HW
WH............HW
WHHHHHH..HHHHHHW
WWWWWWWWWWWWWWWW