1 templates
P0
WWWWWWWWWWWWWWWW
W..............W
W.MMMMMMMMMMMM.W
W.MIIIIIIIIIIM.W
W.MIMMMMMMMMIM.W
W.MIMIIIMIIMIM.W
W.MIIIMIIIBMIM.W
W.MMMMMMMMMMIM.W
W..............W
WWWWWWWWWWWWWWWW