1 templates
V0
WWWWWWWWWWWWWWWW
W..............W
W..............W
W..............W
W......V.......W
W..............W
W..............W
W..............W
W..............W
WWWWWWWWWWWWWWWW