1 templates
L0
WWWWWWWWWWWWWWWW
W..............W
W..............W
W....LLLLLL....W
W..............W
W..............W
W....LLLLLL....W
W..............W
W..............W
WWWWWWWWWWWWWWWW