2 templates
T0
WWWWWWWWWWWWWWWW
WLMIIIMIIMMHIILW
WMMIHIMMIIIHIIIW
WMIIHIHHHHIIMMMW
WIHIHIITIIHIHIIW
WIIIMHHHHIHIHIIW
WMMIIHHMMIHIIIMW
WHMMIIIIHIIIMMHW
WLIIHIMIIMIHIILW
WWWWWWWWWWWWWWWW
T1
WWWWWWWWWWWWWWWW
WLIIHMMIIMIIIMLW
WIIIHIIIMMIHIMMW
WMMMIIHHHHIHIIMW
WIIHIHIITIIHIHIW
WIIHIHIHHHHMIIIW
WMIIIHIMMHHIIMMW
WHMMIIIHIIIIMMHW
WLIIHIMIIMIHIILW
WWWWWWWWWWWWWWWW