1 templates
Q0
WWWWWWWWWWWWWWWW
WL............LW
W..............W
W..............W
W......T.......W
W..............W
W..............W
W..............W
WL............LW
WWWWWWWWWWWWWWWW